       SO                        textures/bluestone.xpm




NO     textures/greenlight.xpm



EA  textures/redbrick.xpm
WE     textures/eagle.xpm
    C      0,0,0
                F               245,    244,             249
111111111111111111111111
100000000000000000000001
100000000000000000000001
1000000000000000000000001
100000111110000000000001
100000100010000000000001
100000100010000000000001
100000100010000000000001
100000110110000000000001
100000000000000000000001
100000000000000000000001
100000000000000000000001
100000000000000000000001
100000000000000000000001
10000000000000001111111111111
1000000011			0000000		001
1000100000000S000000001111111
10000001000000000000001
100000010000     000001
100000001000000000000001
111111111000000000000001
110000000000000000000001
11111111100000000000001
111111111111111111111111
